////-//-////////
///-//-/////////
//-//-//////////
//----//////////
///------///////
////----////////
/--------///////
/---//--////////
/---//--////////
/-------////////
/////-//////////
/////-//////////
//-----/////////
//-----/////////
//-----/////////
////////////////